#####################T##################
#o........#..................#........o#
#.##.#.##.##.######.#######.##.##.#.##.#
#.......#.........#..#.........#.......#
#.#.###.#.#####.#.#.##.#.#####.#.###.#.#
#...........#...#.#..#.#...#...........#
###.#.#.###.#.#.#.#.##.#.#.#.###.#.#.###
#.......#.#..................#.#.#.....#
#.####F##.###.#.#.#.##.#.#.###.#.F####.#
#.####F#.#.#.....#.....#.....#.....#...#
T.#.#.#...#.#.#...#.F....#.#.#.....#.#.T
#.#...#.#........#.#.##.#...#...#.#..#.#
#.#.###.####F####.#..#.###.F####.###.#.#
#.#....#..........#.##.....#...#.....#.#
#.#.###...#####.#.#..#.#.#####...###.#.#
#.....#.#.....#.#...#..#.#.....#.#.....#
###.#.#.#####.#.###...##.#.#####.#.#.###
#o..............P...#..#..............o#
#####################T##################
########################################